5,5,1,5,5,1,1,1,1,1 ; 5,2,3,2,5,1,1,1,1,1 ; 1,3,2,3,1,1,1,1,1,1 ; 5,2,3,3,5,1,1,1,1,1 ; 5,5,1,5,5,1,1,1,1,1
4,0,0,0,4 ; 0,0,0,0,0 ; 4,0,0,0,4 ; 0,0,0,0,0 ; 4,0,0,0,4
4,0,0,0,4 ; 0,0,0,0,0 ; 0,0,0,0,0 ; 0,0,0,0,0 ; 4,0,0,0,4
4,0,0,0,4 ; 0,0,0,0,0 ; 0,0,0,0,0 ; 0,0,0,0,0 ; 4,0,0,0,0
0,5,0,5,0 ; 0,0,0,0,0 ; 0,0,0,0,0 ; 0,0,0,0,0 ; 0,5,0,0,0